000000003
000030300
000030300
030030000
111100201
111111111
111111111
