000000000
000000000
000000000
000000000
003002030
003111111
111111111