000000000
000000000
000000000
030000000
111100201
111111111
111111111