000000000
000000000
000000000
030000000
111100200
111111110
111111110